10
-.-.-.-.-.-.-.-.-.-
-.-.-.-.P.-.-.-.G.-
-.-.-.-.-.-.-.-.-.-
-.P.-.-.-.-.-.P.-.-
P.-.-.-.-.-.-.G.-.-
-.-.-.-.P_G.-.-.-.-.-
-.-.-.H_P.-.-.P.-.-.-
-.-.-.-.-.P.-.G.-.-
-.-.-.-.-.-.-.-.P.-
-.-.-.-.-.-.W.-.-.-