10
-.-.-.-.-.H_P.-.-.-.-
-.-.P.-.P_G.-.-.-.G.-
-.-.-.-.-.H_P.-.P.-.-
-.P_G.-.-.W.-.-.P.-.-
H_P.-.-.-.-.-.-.G.-.-
-.-.W.-.P_G.-.-.-.-.-
-.-.-.H_P.-.-.P.-.-.-
-.-.W.-.-.P.-.G.-.-
-.G.-.-.P_G.-.P.-.P.-
-.-.G.-.-.-.W.-.-.-