10
-.-.-.-.-.-.-.-.-.-
-.-.-.-.P.-.-.-.G.-
-.-.-.-.-.-.-.-.-.-
-.P.-.-.W.-.-.P.-.-
P.-.-.-.-.-.-.G.-.-
-.-.W.-.P_G.-.-.-.-.-
-.-.-.H_P.-.-.P.-.-.-
-.-.-.-.-.P.-.G.-.-
-.G.-.-.P_G.-.-.-.P.-
-.-.-.-.-.-.W.-.-.-