10
-.-.-.-.-.H_P.-.-.-.-
-.-.W.-.P_G.-.-.-.G.P
-.-.-.-.-.H_P.-.-.P.-
-.P_G.-.-.W.-.-.P.-.-
H_P.-.P.-.-.-.-.W.-.-
-.-.-.-.P_G.-.G.P_G.-.-
H_P.P_G.-.H_P.-.-.P.H_P.-.-
G.-.W.G.-.-.-.G.-.-
-.-.-.-.P_G.-.W.W.-.-
-.H_P.W.-.-.-.-.-.-.G