10
A.-.W.-.-.-.W.-.-.-
-.W.W.-.P.-.-.-.G.-
W.W.W.-.-.-.W.-.-.-
-.P.-.-.-.-.-.P.-.-
P.-.-.-.-.-.-.G.-.-
-.-.-.-.P_G.-.-.-.-.-
-.-.-.H_P.-.-.P.-.-.-
-.-.-.-.-.P.-.G.-.-
-.-.W.-.-.-.-.-.P.-
-.-.-.-.-.-.-.-.-.-
